#####################
#           #       #
##### ### ### ##### #
#     #   #   #  E# #
# # ### # ### #   # #
# # #   #     #   # #
### ##### ####### # #
#   #   # #     #   #
# ### # ### # #######
#     #     #       #
############### #####
#     #       #     #
# ### # ##### # ### #
#   # # #   # # #   #
### # # # # # ### ###
#   # #   # #   #   #
# ### ##### ### ### #
# #   #   # #   #   #
# # ### # # # ### ###
#S#     #   #       #
#####################
